11111111111111111
1E00C00010010P001
10100101001000001
10100100101010101
100000000C00C0001
11111111111111111